		
	На русском языке	На английском языке
	Документы	Document
	Справочники	Catalog
	Отчеты	Report
	Обработки	DataProcessor
	РегистрыСведений	InformationRegister
	РегистрыНакопления	AccumulationRegister
	РегистрыБухгалтерии	AccountingRegister
	РегистрыРасчета	CalculationRegister
	Конфигурация	Configuration
	ПланыСчетов	ChartOfAccounts
	ПланыВидовРасчета	ChartOfCalculationTypes
	ПланыВидовХарактеристик	ChartOfCharacteristicTypes
	ПланыОбмена	ExchangePlan
	БизнесПроцессы	BusinessProcess
	Задачи	Task
	ПараметрыСеанса	SessionParameter
	Подсистемы	Subsystem
	Интерфейсы	Interface
	ОбщиеКоманды	CommonCommand
	ОбщиеФормы	CommonForm
	КритерииОтбора	FilterCriterion
	ЖурналыДокументов	DocumentJournal
	Последовательности	Sequence
	Константы	Constant
	ОбщиеРеквизиты	CommonAttribute
	Чтение	Read
	Добавление	Insert
	Изменение	Update
	Удаление	Delete
	Проведение	Posting
	ОтменаПроведения	UndoPosting
	Просмотр	View
	ИнтерактивноеДобавление	InteractiveInsert
	Редактирование	Edit
	ИнтерактивноеУдаление	InteractiveDelete
	ИнтерактивнаяПометкаУдаления	InteractiveSetDeletionMark
	ИнтерактивноеСнятиеПометкиУдаления	InteractiveClearDeletionMark
	ИнтерактивноеУдалениеПомеченных	InteractiveDeleteMarked
	ИнтерактивноеПроведение	InteractivePosting
	ИнтерактивноеПроведениеНеОперативное	InteractivePostingRegular
	ИнтерактивнаяОтменаПроведения	InteractiveUndoPosting
	ИнтерактивноеИзменениеПроведенных	InteractiveChangeOfPosted
	ВводПоСтроке	InputByString
	УправлениеИтогами	TotalsControl
	Использование	Use
	Получение	Get
	Установка	Set
	ИнтерактивнаяАктивация	InteractiveActivate
	Старт	Start
	ИнтерактивныйСтарт	InteractiveStart
	Выполнение	Execute
	ИнтерактивноеВыполнение	InteractiveExecute
	Администрирование	Administration
	АдминистрированиеДанных	DataAdministration
	МонопольныйРежим	ExclusiveMode
	АктивныеПользователи	ActiveUsers
	ЖурналРегистрации	EventLog
	ВнешнееСоединение	ExternalConnection
	Automation	Automation
	ИнтерактивноеОткрытиеВнешнихОбработок	InteractiveOpenExtDataProcessors
	ИнтерактивноеОткрытиеВнешнихОтчетов	InteractiveOpenExtReports
	Вывод	Output
	ОбновлениеКонфигурацииБазыДанных	UpdateDataBaseConfiguration
	ТонкийКлиент	ThinClient
	ВебКлиент	WebClient
	ТолстыйКлиент	ThickClient
	РежимВсеФункции	AllFunctionsMode
	СохранениеДанныхПользователя	SaveUserData
	ИзменениеСтандартнойАутентификации	StandardAuthenticationChange
	ИзменениеСтандартнойАутентификацииСеанса	SessionStandardAuthenticationChange
	ИнтерактивноеУдалениеПредопределенныхДанных	InteractiveDeletePredefinedData
	ИнтерактивнаяПометкаУдаленияПредопределенныхДанных	InteractiveSetDeletionMarkPredefinedData
	ИнтерактивноеСнятиеПометкиУдаленияПредопределенныхДанных	InteractiveClearDeletionMarkPredefinedData
	ИнтерактивноеУдалениеПомеченныхПредопределенныхДанных	InteractiveDeleteMarkedPredefinedData